################################
#  #                           #
#  #                           #
#  #  ####                     #
#  ####  #                     #
#        #                     #
#    #####                     #
#                              #
#                              #
#                              #
#                              #
#                              #
#             ###              #
#                              #
#                              #
#              $               #
#                              #
#                              #
#                              #
#                              #
#      ### # ### #             #
#      # # # # # #             #
#      ##  # ##  #             #
#      #   # #   #             #
#      #   # #   #             #
#                              #
#                              #
#                              #
#                              #
#                              #
#                              #
################################


#####  #####
    #  #   #
    #  #   #
#####  #   #